0 0 176 0 0 0 0 0 0 0 253 0 0 0 0 0 0 0 178 178 178 0 0 0 0 0 0 0 176 0 254 254 254 254 254 0 0 0 0 0 0 0 254 0 0 0 0 0 0 178 0 0 0 0 0 0 178 0 0 178 178 0 0 178 0 0 0 0 0 0 178 178 0 0 254 178 0 0 0 178 0 178 0 178 177 176 176 0 0 0 0 176 0 177 0 0 176 0 0 0 0 0 176 0 0 0 0 177 177 0 21 
176 219 176 0 0 0 0 0 0 0 176 0 0 0 0 178 0 0 0 0 0 178 254 254 254 254 254 0 0 176 254 254 0 254 254 254 0 0 0 0 0 0 0 178 0 0 0 0 253 0 0 176 177 0 0 0 177 176 177 178 178 0 0 0 0 178 178 0 0 0 0 0 178 0 0 0 0 178 178 0 0 176 0 178 0 0 0 0 0 176 0 0 0 0 176 0 176 0 0 176 177 0 176 0 0 0 0 0 178 0 0 
0 0 0 0 0 0 0 0 177 176 178 176 0 178 178 0 176 0 0 178 0 176 0 0 0 0 254 0 178 176 254 254 254 0 254 0 0 0 178 0 0 0 0 0 0 0 177 0 176 177 176 0 178 176 178 254 178 176 176 253 253 0 0 178 178 0 0 0 0 0 178 178 0 0 0 0 0 0 178 0 0 178 0 178 254 177 0 0 0 0 0 0 176 0 0 0 0 0 0 0 0 176 0 219 176 176 176 0 0 177 0 
0 0 35 0 0 0 176 176 0 0 0 178 0 0 0 0 0 0 0 176 0 0 176 0 0 0 254 0 0 176 254 254 178 254 0 176 0 0 178 0 177 0 0 0 0 178 0 178 178 178 0 0 0 176 254 176 254 254 176 253 254 254 254 254 176 0 176 0 178 176 0 0 0 0 0 176 0 0 178 176 0 0 0 177 178 176 176 0 178 0 178 0 176 0 176 0 0 0 0 0 0 176 0 0 0 0 0 177 0 177 0 
0 177 0 178 0 0 178 0 178 178 178 0 0 176 0 0 176 0 0 0 35 0 0 176 0 176 254 178 176 176 254 254 0 0 0 0 0 0 178 0 178 0 0 177 0 0 176 0 0 0 0 0 176 176 0 0 0 0 0 178 254 254 254 254 178 0 176 0 0 0 178 0 0 178 178 176 0 0 0 0 0 0 177 177 0 0 177 0 0 178 0 0 178 0 177 177 0 176 177 0 177 0 176 177 177 0 0 176 0 178 0 
0 0 0 178 0 0 0 0 0 0 176 0 0 0 35 0 0 176 0 0 0 176 178 0 176 0 254 178 176 176 254 254 0 178 178 0 0 176 176 0 177 178 178 176 0 0 176 178 177 176 0 0 176 178 254 177 0 176 254 176 254 254 254 254 176 0 176 0 0 0 0 0 0 0 0 0 0 177 178 176 0 0 178 0 0 0 0 0 0 0 0 177 0 0 177 178 0 0 0 0 0 0 0 0 0 177 0 176 0 178 0 
178 176 176 176 176 178 0 176 176 0 176 0 0 0 176 0 0 178 0 0 0 178 0 0 0 0 254 178 254 254 219 176 178 177 176 0 0 177 0 0 177 178 0 0 253 176 177 0 176 0 0 178 0 177 177 176 0 0 176 176 254 176 178 177 176 176 0 0 0 0 177 177 177 177 0 0 178 178 0 0 0 177 177 176 178 0 178 177 178 177 0 0 178 177 178 0 178 0 0 176 0 253 176 0 0 0 0 178 35 0 0 
0 176 254 178 0 254 176 178 0 176 0 176 0 176 178 0 0 0 0 0 0 178 0 0 254 254 254 254 254 177 178 0 176 0 178 178 0 0 0 254 176 0 0 178 0 177 0 0 0 0 176 178 176 0 0 176 178 0 0 178 178 0 176 0 0 177 0 176 0 177 0 0 0 0 177 0 0 176 177 253 177 0 177 178 0 177 178 177 177 0 176 0 0 0 0 0 0 178 178 0 0 0 0 177 0 0 176 35 35 177 0 
0 176 0 0 0 176 0 0 0 0 0 178 0 176 0 176 178 0 0 0 253 0 177 0 254 178 178 0 0 0 178 0 0 176 177 0 0 0 177 0 0 0 0 0 0 0 0 0 176 176 0 0 176 0 0 176 0 0 0 0 0 0 0 176 0 0 177 176 0 0 253 177 0 0 177 0 0 0 178 0 0 177 0 253 0 0 178 0 0 177 0 178 177 178 177 0 0 0 178 177 176 0 0 0 253 0 178 178 35 176 0 
0 178 0 176 254 254 0 176 178 178 0 176 0 0 0 176 0 176 0 177 178 0 176 0 254 254 254 178 0 176 0 0 177 0 0 177 176 176 176 0 0 0 177 0 0 0 0 0 178 177 0 0 0 176 0 176 0 176 177 253 177 253 0 0 0 0 0 0 178 0 0 0 0 0 178 178 0 177 178 0 0 0 0 0 0 178 0 0 0 176 0 0 0 0 0 0 0 0 176 178 0 178 176 177 0 0 177 178 178 35 0 
178 0 176 0 178 176 0 0 178 254 0 178 178 178 0 177 178 178 0 254 176 0 254 176 177 178 254 176 178 0 0 0 177 0 178 0 0 0 0 0 0 178 176 0 178 0 176 0 0 176 0 176 0 176 0 178 177 176 0 0 0 0 177 176 0 0 0 177 0 0 0 254 0 0 0 177 0 176 0 0 0 0 0 0 0 0 177 0 0 178 0 0 0 177 177 177 0 178 178 0 0 0 0 177 0 0 177 176 177 178 0 
178 178 0 178 0 0 0 178 254 219 176 178 0 177 0 0 0 0 176 176 178 178 177 178 176 254 178 178 0 177 0 176 177 178 0 176 0 0 176 177 0 176 0 0 0 176 0 0 177 176 0 176 176 176 0 177 177 0 0 0 0 176 0 0 0 178 0 0 0 176 178 254 177 0 177 178 178 0 0 0 178 178 0 0 0 0 178 0 0 0 0 176 0 176 0 178 0 176 177 177 0 176 0 0 178 0 0 0 177 178 254 
0 0 176 178 0 0 0 178 0 0 177 0 178 176 0 176 0 0 0 178 176 0 0 0 177 0 0 177 0 0 0 0 0 176 0 176 0 176 0 0 0 178 176 0 0 0 0 0 0 178 176 177 0 0 176 0 176 0 178 0 0 176 177 176 0 0 178 0 177 177 0 254 254 176 0 0 178 0 0 0 176 177 254 177 0 0 0 176 0 0 0 0 0 0 177 0 0 0 178 0 176 0 0 0 176 254 176 178 0 178 254 
0 0 254 219 254 176 178 0 0 176 178 0 0 0 0 178 178 0 178 177 176 177 0 178 0 0 177 0 0 0 0 0 177 0 178 0 0 0 0 177 176 0 177 176 176 177 0 0 176 0 0 0 0 0 176 0 0 0 0 0 0 0 176 0 0 0 0 0 0 0 0 176 176 178 0 178 177 0 0 0 177 177 177 178 0 178 0 0 177 177 0 178 176 178 177 176 0 177 0 0 176 0 176 0 177 178 0 176 177 177 176 
0 176 178 0 0 0 177 177 0 0 176 176 0 0 0 176 0 0 177 0 0 176 0 0 0 178 177 178 0 0 176 0 0 0 176 0 176 0 176 0 176 0 0 0 0 0 0 0 0 177 176 0 0 0 0 0 177 177 0 35 0 177 177 0 178 176 0 177 0 0 177 0 177 177 176 0 0 0 0 177 178 177 177 178 0 177 0 176 0 0 0 0 0 0 0 178 0 178 0 0 0 0 0 0 0 0 178 0 0 176 176 
0 0 0 176 0 0 176 0 0 0 0 177 0 177 0 0 0 176 176 0 176 176 0 177 177 0 0 0 176 176 176 0 176 0 0 0 176 0 0 0 0 176 176 0 176 177 0 0 0 0 176 0 0 0 177 0 177 0 176 0 0 177 0 177 0 0 0 177 0 0 0 0 177 0 0 0 0 176 177 176 0 177 0 0 253 0 0 178 0 0 0 0 0 0 177 0 0 0 177 0 0 0 0 178 0 0 0 0 0 176 0 
0 178 0 177 177 177 0 176 178 0 177 178 0 178 178 0 0 0 178 0 177 178 0 0 0 0 0 176 0 0 0 0 0 0 0 0 0 0 0 176 0 176 35 0 0 0 35 176 176 0 177 0 0 176 177 176 0 0 176 0 0 177 0 0 0 177 0 176 177 0 176 0 0 178 253 177 177 177 178 0 0 0 0 0 0 178 0 0 0 177 178 0 176 0 0 0 0 0 177 178 0 0 0 0 0 178 178 177 0 0 176 
0 0 176 178 176 0 0 0 0 177 0 0 0 176 254 0 0 0 0 176 0 0 0 0 177 35 0 0 176 0 0 35 0 0 0 0 35 0 0 177 0 0 0 0 0 0 0 0 0 0 35 176 176 0 177 176 178 0 178 0 0 0 0 177 178 0 177 177 0 0 0 176 178 177 0 0 0 176 0 178 176 0 178 0 0 0 176 177 176 0 178 0 0 177 178 0 0 177 177 177 0 178 0 0 176 0 0 177 177 177 176 
176 0 178 177 0 0 0 35 0 0 0 178 0 0 177 176 178 176 0 0 0 177 0 0 178 0 0 0 176 0 0 0 0 0 176 176 0 0 178 177 0 0 0 0 0 0 0 0 176 35 177 178 176 0 0 176 177 0 178 0 0 0 0 0 0 0 178 0 177 178 0 0 178 177 0 0 0 0 0 0 178 0 0 176 178 0 0 0 178 0 178 0 178 178 178 0 0 177 0 0 0 176 0 177 177 178 0 0 176 0 0 
0 0 176 0 0 178 0 0 178 178 0 0 0 176 178 0 177 0 176 0 178 0 176 0 0 0 176 0 178 176 178 176 177 0 0 0 178 177 177 0 0 0 0 254 254 0 0 0 0 176 176 176 176 0 178 0 176 0 0 177 176 0 176 178 176 0 176 0 0 0 177 176 178 178 178 177 178 0 178 0 0 0 178 0 177 0 178 0 178 0 0 178 178 0 0 0 0 0 0 0 0 0 0 0 178 176 0 176 0 0 0 
0 253 0 0 177 0 0 0 0 178 177 0 176 0 0 178 0 0 0 0 177 178 0 177 0 0 0 0 0 176 177 0 0 0 0 178 176 176 35 0 0 0 0 254 254 254 0 0 0 35 35 177 0 178 0 0 0 0 177 0 0 0 177 0 176 0 0 0 0 178 178 0 0 176 0 0 176 0 177 0 176 177 0 178 0 0 0 0 0 176 177 177 178 0 176 178 0 0 0 0 0 176 0 176 178 0 177 0 178 176 176 
0 176 0 0 177 0 176 176 178 0 0 178 0 0 0 177 176 0 0 0 0 0 0 177 176 0 177 0 178 0 176 0 0 0 177 0 176 0 176 0 0 0 0 0 254 0 0 0 0 176 177 0 0 0 0 0 35 0 0 0 0 0 0 178 178 0 0 177 0 0 0 177 0 0 176 0 0 178 178 0 176 0 0 0 0 0 0 0 0 178 178 178 0 0 0 176 177 0 176 0 0 0 0 176 0 0 0 177 178 176 176 
176 176 176 0 177 0 177 0 0 178 178 0 0 0 178 176 177 177 177 0 0 178 0 177 178 0 0 0 177 0 177 0 176 0 0 177 176 0 0 176 0 0 0 0 0 0 0 0 176 176 0 0 0 176 178 0 0 0 0 0 0 0 178 177 0 0 176 178 176 178 0 177 178 0 0 0 176 0 177 177 0 177 0 0 0 0 0 178 176 178 0 178 0 0 0 0 0 176 0 0 0 176 0 0 0 0 176 177 178 0 0 
176 177 0 0 177 0 177 178 178 177 177 177 0 178 177 0 0 176 0 0 177 177 0 0 176 0 0 0 0 0 0 0 176 0 176 0 0 176 176 0 177 176 0 0 0 0 0 0 176 0 0 0 0 176 0 178 177 177 0 0 0 0 0 0 0 178 0 0 0 0 177 0 176 0 0 0 177 0 177 0 0 177 0 0 0 178 0 253 0 0 176 178 176 0 177 0 0 176 178 0 178 178 176 0 0 176 0 0 176 0 0 
177 177 177 176 0 0 176 0 0 0 0 0 178 0 0 178 0 0 0 0 176 0 0 0 177 176 0 0 176 0 176 178 176 0 176 176 176 176 0 178 0 0 35 176 0 176 35 178 0 0 0 0 0 0 176 0 0 178 0 178 254 177 0 177 0 0 176 176 0 0 0 177 0 0 0 0 0 0 0 0 0 178 0 178 0 0 253 0 0 0 178 176 0 176 0 35 0 0 0 0 0 0 0 0 0 0 0 0 0 176 0 
0 0 0 0 177 0 0 177 176 177 0 178 178 0 0 0 0 0 177 178 0 0 0 0 177 178 178 0 0 0 177 0 0 0 177 176 0 176 0 0 0 177 176 35 0 35 176 176 178 178 0 0 0 0 0 0 177 177 0 0 0 0 0 178 0 0 0 0 0 0 0 0 177 0 0 178 0 0 177 0 0 0 176 0 0 0 0 176 0 0 0 176 176 0 176 0 0 178 0 178 0 0 0 0 0 0 0 177 0 176 0 
0 0 178 254 0 0 178 0 0 0 178 176 177 178 0 0 177 177 0 0 0 0 177 177 0 254 176 176 177 0 0 0 0 0 0 177 176 0 176 177 176 178 177 0 0 176 0 0 0 0 176 254 177 0 177 177 0 176 176 0 0 0 0 0 0 0 0 0 176 177 0 0 0 176 0 178 0 178 177 0 0 176 176 0 0 177 0 0 178 0 0 177 0 0 0 0 0 0 0 0 0 0 0 178 0 0 0 0 177 0 0 
0 0 177 0 0 0 0 178 0 0 0 178 0 0 0 0 177 178 0 0 176 0 0 0 0 0 177 0 0 0 0 0 176 178 0 0 0 0 0 0 0 178 178 0 0 0 0 176 0 0 176 177 176 0 0 178 0 0 0 178 0 0 0 0 0 0 0 0 0 0 178 0 0 0 0 176 177 176 0 0 0 176 0 177 0 176 0 0 176 0 0 176 0 0 0 176 0 0 0 176 0 253 0 0 177 0 0 176 176 177 0 
0 0 0 0 0 0 0 0 0 176 0 0 0 0 0 178 0 178 0 0 177 0 0 0 177 178 177 0 0 0 176 0 0 0 0 0 176 0 177 0 0 0 0 0 0 176 0 177 0 0 0 0 0 0 177 178 0 178 0 0 0 0 0 178 0 0 177 177 0 176 0 178 0 0 0 177 0 0 35 0 0 0 0 176 0 178 0 177 0 0 0 0 0 178 0 0 0 0 176 178 0 0 253 0 0 0 0 177 178 177 0 
0 0 177 0 178 0 178 178 0 0 176 178 0 0 0 177 0 178 0 0 0 178 0 177 178 0 176 0 178 176 0 0 0 0 177 0 0 0 176 0 0 0 0 176 0 177 0 176 177 176 0 0 0 0 0 0 0 0 0 0 0 0 0 176 254 178 0 0 176 0 0 178 0 177 0 0 0 0 177 0 0 0 177 0 0 0 0 0 0 0 0 0 0 0 0 0 0 0 0 0 177 0 0 0 0 0 0 176 178 0 0 
178 0 0 0 0 0 0 0 0 0 0 178 0 0 176 177 177 0 0 35 177 0 0 0 177 0 178 177 0 0 0 176 178 0 178 0 0 0 0 0 0 178 177 176 176 0 0 176 0 178 178 178 176 0 0 178 0 176 0 178 0 0 0 0 0 0 0 35 0 0 0 0 0 0 0 176 0 0 0 0 178 176 177 0 0 176 0 176 178 0 0 176 0 0 177 176 0 178 0 0 0 0 0 0 0 177 178 0 176 0 177 
0 0 178 0 0 0 178 0 254 0 0 0 0 0 0 177 0 177 0 0 178 0 0 0 0 177 176 0 0 0 0 0 0 176 254 177 177 178 178 177 178 0 177 176 178 178 0 0 178 176 178 0 178 0 177 0 0 0 0 177 0 0 0 0 177 0 0 0 0 177 0 177 176 0 0 0 0 177 0 0 176 0 0 0 176 0 0 177 0 0 0 0 0 0 0 0 0 0 0 0 0 0 0 0 0 176 0 0 176 176 177 
0 0 178 178 178 0 178 176 0 0 178 0 0 0 178 0 0 177 0 177 178 0 177 177 0 0 0 0 176 178 177 178 178 178 0 176 0 0 177 178 0 176 177 0 0 176 177 0 0 0 0 0 0 0 177 0 0 0 0 0 178 0 0 177 0 0 177 178 0 178 0 177 177 177 176 178 35 253 253 177 177 178 0 0 176 0 0 0 0 91 82 101 99 111 114 100 93 0 51 48 0 72 80 0 0 0 0 0 0 0 0 
0 177 0 0 177 0 0 178 178 0 0 178 176 0 0 0 178 0 0 176 0 0 178 0 0 0 0 178 0 0 0 0 0 178 0 0 176 177 0 0 0 0 0 0 0 178 0 177 0 0 176 0 0 177 0 0 177 0 0 0 177 0 0 0 0 177 177 176 0 178 176 254 254 254 176 254 254 254 178 254 254 176 0 0 0 0 0 178 0 91 82 101 99 111 114 100 93 0 97 108 108 0 99 111 105 110 115 178 0 176 0 
176 0 0 0 177 176 177 0 0 0 0 178 0 178 178 0 0 0 0 177 0 177 0 176 176 0 0 177 0 177 0 176 0 0 177 0 0 0 176 176 0 176 176 0 0 0 178 0 176 0 176 0 35 0 0 0 0 0 0 0 177 35 0 0 0 0 0 0 177 176 254 254 254 254 254 178 254 254 254 253 176 0 35 0 0 0 0 0 0 0 0 0 178 0 0 0 0 178 0 0 0 0 0 0 0 0 0 0 0 176 177 
0 0 0 0 0 0 0 0 0 0 177 0 0 0 0 0 0 0 177 0 0 177 177 0 178 0 177 0 0 0 0 178 177 0 176 177 178 0 0 178 0 0 0 177 0 0 35 0 0 0 0 0 0 0 177 177 0 0 177 177 0 0 177 178 176 176 0 176 0 0 176 254 254 254 254 254 254 254 254 254 35 0 0 0 0 0 0 0 176 176 0 0 0 177 0 0 0 0 0 0 0 177 0 0 0 0 0 0 0 0 178 
254 0 0 0 0 0 0 0 177 177 177 0 177 0 177 178 0 178 254 0 178 176 0 0 176 177 177 177 0 0 178 177 0 0 0 0 0 177 0 0 0 0 0 0 0 0 0 176 177 176 177 0 0 177 0 0 178 0 0 0 0 0 177 0 0 176 0 176 178 0 177 254 254 254 254 254 254 254 254 254 35 0 0 0 0 176 0 178 0 0 0 176 178 0 0 0 177 0 0 0 176 0 177 0 0 0 254 177 0 0 254 
1