0 0 178 64 0 178 254 0 178 254 0 0 253 0 0 0 0 0 0 0 0 0 0 0 35 35 35 35 35 35 0 0 0 35 253 178 254 254 254 254 254 254 254 254 254 254 254 219 0 0 64 0 0 0 0 0 0 0 0 0 0 0 0 0 0 0 0 0 0 0 0 0 0 0 0 0 0 0 0 0 0 0 0 0 0 0 0 0 0 0 0 0 0 0 0 0 0 0 0 0 0 0 0 0 0 0 0 0 0 0 0 
0 0 178 0 0 178 0 0 178 254 0 0 253 0 0 0 0 0 0 0 0 0 0 0 176 176 176 176 176 176 0 0 0 35 253 178 254 254 254 254 254 254 254 254 254 254 254 178 64 0 0 0 0 0 0 0 35 35 35 0 0 0 35 35 35 35 0 35 35 35 35 35 35 35 35 35 0 0 0 35 35 0 0 0 0 176 176 176 176 176 176 177 177 177 177 176 176 176 176 176 176 176 177 177 176 176 176 0 0 0 0 
178 219 178 178 219 178 178 219 178 254 0 0 253 0 0 0 0 64 0 0 0 0 0 0 176 254 0 254 254 176 254 0 0 35 253 178 254 254 254 254 254 254 254 254 254 254 254 178 0 0 35 35 35 35 35 35 35 0 35 35 35 35 35 0 35 35 35 35 0 0 0 0 0 35 0 0 35 35 35 35 35 35 35 0 176 176 176 176 0 0 0 0 0 0 0 0 0 0 0 0 0 0 0 0 176 176 176 176 0 0 0 
0 0 0 0 0 0 0 0 178 254 0 0 253 0 0 0 0 0 176 176 176 176 176 253 176 0 0 0 254 176 4 254 0 35 253 178 254 254 254 254 254 254 254 254 254 254 254 178 0 35 35 0 0 0 0 0 0 0 0 0 0 0 0 35 0 0 0 0 64 0 64 0 0 0 0 0 0 35 35 0 0 0 176 176 177 177 0 0 0 176 176 176 177 177 177 177 177 177 177 176 176 176 176 0 0 176 176 177 177 0 0 
0 0 0 0 0 0 0 0 178 254 0 0 253 0 0 0 0 0 176 254 0 0 0 0 176 0 254 0 0 178 178 178 178 178 253 178 254 254 254 254 254 254 254 254 254 254 254 178 35 35 0 0 0 0 0 0 0 0 0 0 0 0 35 0 0 0 0 178 178 219 178 178 178 178 0 0 0 0 0 0 0 176 176 176 176 0 0 176 177 176 176 0 0 0 0 0 0 0 0 0 0 176 176 176 0 0 0 176 177 176 0 
177 35 177 176 176 176 176 176 176 176 176 176 176 0 0 0 0 0 176 0 0 0 0 0 176 0 0 0 0 178 254 4 254 178 253 178 254 254 254 254 254 254 254 254 254 254 254 178 0 0 0 0 0 253 0 0 0 0 0 0 0 35 0 0 0 0 0 178 64 254 254 254 4 178 0 0 0 0 0 0 0 176 176 176 0 0 176 177 177 0 0 0 0 0 64 0 0 64 0 0 0 0 0 176 176 176 0 176 176 176 0 
0 0 0 176 0 0 0 64 0 0 0 0 176 0 0 0 0 0 176 0 0 0 0 0 253 0 0 0 0 178 254 254 254 178 253 178 254 254 254 254 254 254 254 254 254 254 254 178 0 0 0 0 253 253 253 0 0 0 0 0 35 0 0 0 0 0 0 178 254 254 254 254 254 178 0 0 0 0 0 0 0 176 176 0 0 176 177 177 0 0 0 0 64 0 0 0 0 0 0 64 0 0 0 0 176 176 0 0 176 0 0 
0 0 0 176 0 177 178 0 0 0 0 0 176 0 0 0 0 0 176 254 0 0 0 0 176 176 176 176 253 178 178 219 178 178 253 178 219 178 178 178 178 178 178 178 178 178 178 178 0 0 0 0 0 253 0 0 0 0 0 35 0 0 0 0 0 0 0 178 4 254 254 254 4 178 0 0 0 0 0 0 176 177 176 0 176 176 176 0 0 64 0 0 0 0 0 254 0 0 0 0 0 64 0 0 0 176 176 0 176 0 176 
0 254 0 176 0 0 178 0 0 0 0 0 176 0 0 0 0 0 176 254 254 0 0 0 176 4 254 176 0 0 0 0 176 4 253 178 35 0 35 0 178 254 253 0 0 0 0 0 64 0 0 0 0 0 0 0 0 0 35 0 0 0 0 0 0 0 0 178 178 178 178 178 178 178 0 0 0 0 0 0 176 177 176 0 176 176 0 0 0 0 0 0 0 0 254 0 254 0 0 0 0 0 0 64 0 176 176 0 176 0 176 
0 254 0 176 0 4 178 0 0 176 0 0 35 0 0 0 0 0 176 254 254 254 0 254 176 254 254 176 0 176 176 0 176 254 253 178 35 35 35 35 178 253 0 0 0 0 0 0 0 0 0 0 0 0 0 0 0 35 0 0 0 0 0 0 0 0 64 0 0 35 0 0 0 0 0 0 0 0 0 0 177 176 176 0 177 176 0 0 0 0 254 254 254 254 254 4 254 254 254 254 254 0 0 0 0 0 176 0 176 0 177 
0 254 0 176 0 0 178 0 0 0 0 0 176 0 0 0 0 0 176 176 176 176 176 176 176 253 253 176 0 176 176 254 176 254 253 178 0 35 0 35 178 0 0 0 0 0 0 0 0 0 0 0 0 0 0 0 35 0 0 0 0 0 0 0 0 0 0 0 64 0 0 0 0 0 0 0 0 0 0 0 176 176 176 0 177 176 0 0 64 0 0 0 254 0 254 254 254 0 254 0 0 0 0 64 0 0 64 0 177 0 177 
0 0 0 176 0 177 178 64 0 0 0 0 176 0 0 0 0 64 0 0 0 0 0 0 64 0 0 176 0 0 254 254 176 254 253 178 35 35 0 0 178 0 0 0 0 253 0 0 0 0 0 0 0 0 0 35 0 0 0 0 177 177 177 177 177 177 177 177 0 0 0 0 0 0 0 0 0 0 0 35 176 176 176 0 177 176 0 0 0 0 0 254 0 254 254 0 254 254 0 254 0 0 0 0 0 0 176 176 176 0 177 
0 0 0 176 0 0 0 0 0 64 0 0 176 0 0 0 0 0 0 0 0 0 0 0 0 0 64 176 176 176 176 176 176 4 253 178 35 35 35 0 178 0 0 0 253 253 253 0 0 0 0 0 0 0 35 0 0 0 0 35 177 254 219 219 219 219 219 177 0 0 0 253 0 0 0 0 0 0 35 0 0 176 176 0 177 176 176 0 0 64 254 254 254 0 0 0 0 0 254 254 254 0 0 64 0 0 176 176 0 0 177 
177 35 177 176 176 176 176 176 176 176 176 176 176 0 0 0 0 0 0 0 0 0 0 0 0 0 177 254 0 0 0 0 254 176 253 178 64 35 35 35 178 0 0 0 0 253 0 0 0 0 0 0 0 35 0 0 0 0 35 0 177 219 219 4 4 219 219 177 0 0 253 253 253 0 0 0 0 35 0 0 0 176 176 0 176 176 176 0 0 0 254 0 0 0 0 0 0 0 0 0 254 64 0 0 0 176 177 176 0 176 177 
0 0 0 35 35 0 35 35 0 0 0 0 35 0 0 0 0 0 0 0 0 0 0 0 0 219 0 0 0 0 0 0 0 176 253 178 4 254 254 64 178 0 0 0 0 0 0 0 0 0 0 0 35 0 0 0 0 35 0 0 177 219 219 219 219 219 219 177 0 0 0 253 0 0 0 0 35 0 0 0 0 176 177 0 0 176 176 176 0 0 0 0 64 0 0 0 0 0 0 0 0 0 0 0 0 176 176 0 0 177 177 
35 0 35 35 35 0 0 0 35 35 35 0 35 0 0 0 0 0 0 0 0 0 0 0 177 0 0 0 0 254 64 0 0 176 253 178 35 35 254 35 178 0 0 0 0 0 0 0 0 0 0 35 0 0 0 0 35 0 0 0 177 219 219 219 219 219 219 177 0 0 0 0 0 0 0 35 0 0 0 0 0 176 177 176 0 0 176 176 176 0 0 0 0 0 0 0 64 0 0 64 0 0 177 177 176 176 0 0 176 177 0 
35 0 35 0 35 35 0 35 35 35 0 35 35 0 0 0 0 0 0 0 0 0 0 177 0 0 0 0 254 0 0 0 0 176 253 178 4 4 254 35 178 0 0 0 0 0 0 0 0 0 35 0 0 0 0 35 0 0 0 254 177 219 219 219 219 219 219 177 0 0 0 0 0 0 35 0 0 0 0 0 0 176 176 176 176 0 176 177 177 177 176 0 0 0 0 0 0 0 0 0 0 0 177 176 176 0 0 176 176 176 0 
35 0 35 0 35 35 0 35 0 0 35 35 35 0 0 0 0 0 0 0 0 0 177 0 0 64 0 0 0 0 254 0 0 176 253 178 4 35 35 35 178 253 253 253 253 253 253 253 253 253 177 177 177 177 177 177 177 177 177 177 177 219 219 219 219 219 219 177 0 0 0 0 0 35 0 0 0 0 0 0 0 176 176 176 176 0 0 0 176 176 176 176 176 176 0 0 0 0 0 0 176 176 0 0 0 0 176 176 176 0 0 
0 0 35 0 35 0 35 35 0 0 35 0 35 0 0 0 0 0 0 0 0 177 254 0 0 254 0 0 0 0 0 0 0 176 253 178 254 254 254 254 178 0 0 0 0 0 0 0 0 0 177 254 219 219 219 219 219 219 219 219 219 219 219 219 219 219 219 177 0 0 0 0 35 0 0 0 0 0 0 0 0 0 176 177 177 176 176 0 0 0 176 176 176 176 176 176 177 177 176 176 176 0 0 176 177 177 177 176 0 0 0 
0 35 35 35 0 35 0 0 0 35 35 0 35 0 0 0 0 0 0 0 177 0 0 0 0 0 0 0 0 254 0 0 0 176 253 178 35 35 35 254 178 0 0 0 0 0 0 0 0 0 177 219 219 219 219 219 219 219 219 219 219 219 219 219 219 219 219 177 0 0 0 35 0 0 0 0 0 0 0 0 0 0 0 176 177 177 176 176 176 0 0 0 0 0 0 0 0 0 0 0 0 0 176 177 177 176 0 0 0 0 0 
0 0 0 35 0 35 0 35 35 35 35 0 35 0 0 0 0 0 0 0 177 254 64 254 0 0 0 0 64 0 0 254 0 176 253 178 178 178 178 178 178 0 0 0 0 0 0 0 0 0 177 219 219 219 219 219 219 219 219 219 219 219 219 219 219 219 219 177 0 0 35 0 0 0 0 0 253 0 0 0 0 0 0 0 35 35 176 176 176 176 176 177 177 177 177 176 176 176 176 176 176 253 0 0 0 0 0 0 0 0 0 
0 35 0 0 0 35 0 0 35 35 0 0 35 64 0 0 0 0 0 64 177 0 0 0 254 0 254 0 0 0 0 0 64 176 253 178 0 0 0 0 0 64 0 0 0 0 0 0 0 0 177 219 219 219 219 219 219 219 219 219 219 219 219 219 219 219 254 177 0 35 0 0 0 0 0 253 253 253 0 0 0 0 0 35 35 0 0 0 0 0 0 0 0 0 0 0 0 0 0 0 0 0 0 0 0 0 0 0 0 0 0 
176 176 176 176 176 176 176 176 176 176 176 176 176 176 253 253 253 253 253 176 176 176 176 176 176 176 176 176 176 176 176 176 176 4 253 178 0 0 0 0 0 0 0 0 0 0 0 0 0 0 177 219 219 219 219 219 219 219 177 177 177 177 177 177 177 177 177 177 35 0 0 0 0 0 0 0 253 0 0 0 0 0 0 35 35 0 0 0 0 0 0 0 0 0 0 0 0 0 0 253 0 0 0 0 0 0 0 0 0 0 0 
4 4 4 253 253 253 253 253 253 253 253 253 253 177 35 35 35 35 35 177 253 253 253 253 253 253 253 253 253 253 253 253 253 253 253 178 0 0 253 0 0 0 0 0 0 0 0 0 0 0 177 219 219 219 219 219 219 219 177 0 0 0 35 0 0 0 0 0 0 0 0 0 0 0 0 0 0 0 0 0 0 0 0 0 35 0 0 0 0 0 0 0 0 0 0 0 0 0 253 253 253 0 0 0 0 0 0 0 0 0 0 
178 178 178 219 178 178 178 178 178 178 178 178 219 178 253 253 253 253 253 178 178 178 178 178 178 178 178 178 178 219 178 178 178 178 178 178 0 253 253 253 0 0 0 0 0 0 0 0 0 0 177 219 219 219 219 219 219 219 177 0 0 35 0 0 0 0 0 0 0 0 253 0 0 0 0 0 0 0 0 0 0 0 35 35 35 0 0 0 0 0 0 253 0 0 0 0 0 0 0 253 0 0 0 0 0 0 0 0 0 176 0 
254 0 0 0 0 254 0 0 0 0 254 177 35 35 0 0 0 0 0 35 177 35 0 0 0 0 0 0 0 0 0 0 0 254 254 176 0 0 253 0 0 0 0 0 253 0 0 0 0 0 177 64 219 219 64 219 219 254 177 0 35 0 0 0 0 0 0 0 0 253 253 253 0 0 0 0 0 0 0 0 35 35 35 0 0 0 0 0 0 0 253 253 253 0 0 0 0 0 0 0 0 0 0 0 0 0 0 0 176 176 0 
0 35 0 0 35 0 0 0 0 0 0 35 177 35 0 0 0 0 0 35 177 35 0 0 0 0 0 0 0 0 0 0 0 64 254 176 0 0 0 0 0 0 0 253 253 253 0 0 0 0 177 177 254 254 177 177 177 177 177 35 0 0 0 0 0 0 0 0 0 0 253 0 0 0 0 0 0 0 0 0 35 0 0 0 0 0 0 0 0 0 0 253 0 0 0 0 0 0 0 0 0 176 176 0 0 0 0 176 176 176 0 
0 35 0 0 0 0 0 35 0 0 0 35 177 35 0 0 0 0 0 35 177 35 0 0 0 0 0 0 0 0 0 0 0 0 0 176 0 0 0 0 0 0 0 0 253 0 0 0 0 0 0 64 254 254 64 0 0 0 35 0 0 0 0 0 0 0 0 0 0 0 0 0 0 0 0 0 0 0 0 0 35 0 0 0 0 0 0 0 0 0 0 0 0 0 0 0 0 0 0 0 176 35 176 0 0 176 219 0 176 176 0 
0 0 0 35 0 254 0 0 0 0 0 35 177 35 0 0 0 0 0 35 177 35 0 0 64 0 0 0 0 0 0 0 0 0 177 176 177 0 0 0 0 0 0 0 0 0 0 0 0 0 0 0 0 0 0 0 0 0 35 0 0 0 0 0 0 176 177 176 0 0 0 0 0 0 0 0 0 0 0 35 91 82 101 99 111 114 100 93 0 49 48 48 0 72 80 0 176 176 0 176 176 176 176 176 0 176 176 0 176 0 0 
0 254 0 0 0 0 0 35 0 35 0 35 177 35 0 0 0 0 0 35 177 35 0 0 0 0 0 0 0 0 0 0 0 64 0 0 0 64 0 0 0 0 0 0 0 0 0 0 0 0 0 0 0 0 0 0 0 0 35 0 0 177 176 176 176 176 0 0 0 254 0 0 0 0 0 0 0 0 0 35 91 82 101 99 111 114 100 93 0 97 108 108 0 99 111 105 110 115 176 176 35 176 176 176 176 0 176 0 176 0 176 
0 0 0 0 35 0 0 0 0 0 0 35 177 35 64 0 0 0 64 35 177 35 0 0 64 0 64 0 0 0 0 0 0 0 0 0 0 0 0 0 0 0 0 0 0 0 176 176 176 177 0 0 0 0 0 0 0 0 176 176 176 0 0 0 0 0 0 0 0 0 0 0 0 0 0 35 35 35 35 35 0 0 0 0 254 0 0 0 0 0 0 0 0 0 0 176 176 176 176 176 176 176 35 176 176 176 0 0 176 254 176 
0 35 0 0 35 0 0 0 0 0 64 35 35 176 176 176 176 176 176 176 35 35 0 0 0 0 0 0 0 0 0 0 0 64 0 0 0 64 0 0 0 0 0 0 177 176 176 0 0 176 176 0 0 0 0 176 176 177 0 0 0 0 254 0 176 177 176 176 0 0 0 0 0 0 35 35 0 0 0 0 0 0 0 0 254 0 0 0 0 0 0 0 0 0 0 176 176 35 176 0 0 0 176 176 176 0 0 176 176 176 176 
0 35 0 0 0 0 35 0 0 0 0 0 35 35 35 35 35 35 35 35 35 0 0 0 64 0 0 0 0 254 0 0 0 0 177 176 177 0 0 0 0 0 177 176 176 0 0 0 0 0 176 177 176 176 176 0 0 0 254 0 0 176 176 176 0 0 0 0 0 0 0 0 0 0 35 0 0 0 0 253 0 0 0 0 0 0 0 254 0 0 0 0 0 0 176 176 35 176 0 0 176 0 0 0 0 0 176 176 176 35 176 
254 0 35 0 0 0 35 0 64 0 0 64 0 0 0 0 64 0 0 64 0 0 0 0 0 0 0 254 0 0 0 0 0 0 0 176 0 0 0 0 0 0 176 0 0 0 254 0 0 0 0 0 0 254 0 0 0 0 176 176 177 176 0 0 0 0 0 0 0 0 0 0 0 0 35 0 0 0 253 253 253 254 254 0 0 0 0 0 0 0 0 0 0 176 176 35 176 4 4 176 35 176 176 0 176 176 176 0 176 176 176 
0 0 0 0 0 0 0 0 0 0 64 0 0 64 64 0 0 0 64 0 0 0 0 0 0 0 0 0 0 0 254 254 254 254 0 176 0 0 0 0 0 0 0 0 0 0 176 176 176 177 0 0 0 176 176 177 176 176 35 0 0 0 0 0 0 0 0 35 35 0 0 0 0 35 35 0 0 0 0 253 0 0 0 254 0 254 0 0 0 0 0 0 0 176 176 176 176 4 4 4 176 176 176 0 0 0 0 0 0 176 0 
0 35 254 0 0 0 0 64 0 0 0 0 64 0 0 0 64 0 0 0 0 0 0 0 0 0 254 254 0 0 254 254 0 254 254 176 0 0 0 0 0 254 0 0 176 177 0 0 0 176 176 177 176 176 0 0 0 0 35 0 0 0 0 0 0 0 35 35 35 35 35 35 35 0 0 0 0 0 0 0 0 0 0 0 0 0 0 0 0 0 0 0 0 176 176 176 35 176 4 4 176 176 35 176 176 176 0 0 0 0 0 
0 35 0 0 0 0 64 0 0 0 64 0 0 0 64 0 0 0 64 0 0 0 0 0 0 0 0 254 254 0 0 0 0 254 64 176 64 0 0 0 0 0 0 0 0 0 0 0 0 0 0 0 0 0 0 0 0 0 35 0 0 0 0 0 0 35 35 0 0 0 0 0 0 0 0 0 0 0 0 0 0 0 0 0 0 0 0 0 0 0 0 0 176 176 35 176 176 176 176 176 35 176 176 176 35 176 176 176 0 0 21 
2