0 253 0 254 177 4 0 0 0 177 254 0 0 0 177 254 0 0 0 177 254 254 177 254 0 0 0 254 176 35 0 0 0 0 0 0 0 0 0 0 0 0 0 0 0 0 178 253 0 0 0 0 0 0 0 0 0 0 0 0 0 0 0 0 0 253 0 0 0 0 0 0 0 0 0 0 0 0 0 0 0 0 253 64 0 0 0 253 64 0 0 0 0 0 0 0 0 4 177 177 36 0 0 0 0 0 0 0 0 0 0 
253 253 0 0 177 0 0 0 0 177 0 0 0 0 177 0 0 0 0 177 254 254 177 0 0 0 0 0 176 35 0 178 178 178 178 178 0 64 0 0 0 0 0 0 0 0 178 0 35 35 35 35 35 253 253 253 0 0 0 0 0 0 0 0 0 253 0 0 0 0 0 0 0 0 0 0 0 0 0 0 0 0 253 64 0 0 0 253 64 0 0 0 253 0 0 0 177 177 177 0 0 0 0 0 0 177 177 177 177 177 0 
0 0 0 0 177 0 0 0 0 177 0 0 0 0 177 0 0 0 0 177 254 254 177 0 0 0 0 0 176 35 0 178 4 0 254 178 0 0 0 0 0 0 0 0 0 0 178 0 35 0 0 35 0 0 0 253 253 253 253 35 35 35 35 35 35 35 0 0 0 0 0 0 0 0 0 0 0 0 0 0 0 0 253 64 0 0 0 253 64 0 0 253 253 253 0 177 177 177 177 36 0 0 0 0 0 177 177 177 177 177 0 
177 177 177 35 177 177 177 177 35 177 177 177 177 35 177 177 177 177 35 177 177 177 177 64 0 0 0 0 176 35 0 178 0 0 0 178 0 64 0 0 0 0 0 0 0 0 178 0 35 35 35 0 0 0 0 0 0 0 0 35 0 0 0 0 0 35 35 0 0 0 0 0 0 0 0 0 0 0 0 0 0 0 253 64 0 0 0 253 64 0 254 0 253 0 0 0 0 177 177 36 36 36 0 36 177 177 177 177 177 0 0 
254 0 0 0 0 0 0 0 0 0 0 0 0 0 0 0 0 0 0 0 64 219 35 0 0 0 0 0 176 35 0 178 4 0 4 178 0 0 0 0 0 0 0 0 0 0 178 0 0 0 253 0 0 0 0 0 0 0 0 35 35 0 0 0 0 0 35 0 0 0 0 0 0 0 0 0 0 0 0 0 0 0 253 64 0 0 0 253 64 0 0 0 0 0 0 0 0 177 177 177 36 36 36 177 0 0 0 0 0 0 177 
254 0 0 0 0 0 0 0 0 0 0 0 0 0 0 0 0 0 0 0 64 219 35 0 0 0 0 0 176 35 0 178 178 178 178 178 0 64 0 0 0 0 0 0 0 0 178 0 0 0 253 0 0 0 0 0 0 0 0 0 35 0 0 0 0 35 35 253 253 253 253 35 35 35 0 0 0 0 0 0 0 0 253 64 0 0 0 253 64 0 0 0 0 0 0 0 177 177 177 177 177 177 177 177 0 177 177 177 177 177 177 
254 0 0 0 0 0 0 0 0 0 0 0 0 0 0 0 0 0 0 0 64 219 35 0 0 0 0 0 176 35 0 0 0 0 0 0 0 0 0 0 0 0 0 0 0 0 178 0 0 0 0 253 35 35 35 0 0 0 0 0 0 35 35 35 35 35 0 0 0 0 35 35 0 35 35 35 0 0 0 0 0 0 253 64 0 0 0 253 64 0 0 0 0 0 0 0 177 177 177 177 177 177 177 177 0 0 0 0 177 177 177 
177 177 177 35 177 177 177 177 35 177 177 177 177 35 177 177 177 177 35 177 177 177 177 64 0 0 0 0 176 35 0 0 0 0 0 0 0 0 0 0 0 0 0 0 0 0 178 0 0 0 0 0 35 0 35 0 0 254 0 0 0 253 0 0 0 0 0 0 0 0 35 0 0 0 0 35 35 0 0 0 0 0 253 64 0 0 0 253 64 0 0 0 254 0 0 0 0 177 177 177 177 177 177 177 177 177 177 0 0 0 0 
0 0 0 0 177 0 0 0 0 177 0 0 0 0 177 0 0 0 253 177 254 254 253 0 0 0 0 0 176 35 35 35 35 35 35 35 35 35 35 35 0 0 0 0 0 0 178 0 254 0 0 0 35 35 35 0 0 0 0 0 0 253 0 0 0 0 0 0 0 0 35 0 0 0 0 0 35 35 0 0 0 0 253 64 0 0 0 253 64 0 0 0 0 0 0 0 0 0 0 0 177 177 177 177 177 177 177 177 177 177 0 
0 0 0 0 177 0 0 0 0 177 0 0 0 0 177 0 0 0 0 177 254 254 253 0 0 0 0 64 176 176 176 176 176 176 176 176 176 176 176 35 0 64 0 0 64 0 178 0 0 0 0 0 0 0 253 0 0 0 0 0 0 253 0 0 0 0 0 0 0 0 35 0 0 0 0 0 35 35 0 0 0 0 253 64 0 0 0 253 64 0 0 0 0 0 0 0 0 0 0 0 0 177 177 0 177 177 0 177 177 177 219 
254 0 0 0 177 254 0 0 0 177 4 0 0 0 177 4 0 0 0 177 254 254 253 0 0 0 0 0 35 0 35 35 35 35 35 35 35 35 0 219 0 0 0 0 0 0 253 0 0 0 0 0 0 0 253 253 0 0 0 35 35 0 0 0 0 0 0 254 0 0 35 35 35 35 35 35 35 0 0 0 0 0 253 64 0 0 0 253 64 0 0 0 0 0 0 0 0 0 0 254 0 0 0 0 0 0 0 0 177 0 0 
177 177 177 177 177 177 177 177 177 177 177 177 177 177 177 177 177 177 177 177 254 254 253 0 0 0 0 0 0 0 35 35 35 35 35 35 35 35 0 219 0 0 0 0 0 0 253 0 0 0 0 0 254 0 0 253 0 0 35 0 35 35 35 0 0 0 0 0 0 0 0 0 0 253 0 0 0 0 0 0 0 0 253 64 0 0 0 253 64 0 0 0 0 0 0 0 0 0 0 0 0 0 0 0 0 0 0 0 0 0 0 
177 36 0 74 65 73 76 0 74 65 73 76 0 74 65 73 76 0 36 177 254 254 253 0 0 0 0 0 0 0 35 35 35 35 35 35 35 35 0 219 0 0 0 0 0 0 253 0 0 0 0 254 0 0 0 253 253 0 35 0 0 0 35 35 0 0 0 0 0 0 0 0 0 253 0 0 0 0 0 0 0 0 253 64 0 0 0 253 64 0 0 0 0 0 254 0 0 253 0 0 0 0 0 0 0 0 0 0 0 0 0 
177 177 177 177 177 177 177 177 177 177 177 177 177 177 177 177 177 177 177 177 254 254 253 0 0 0 0 0 0 0 35 35 35 35 35 35 35 35 0 219 0 0 0 0 0 0 253 0 0 0 0 0 0 0 0 0 0 35 0 0 0 0 0 35 35 253 253 253 253 253 0 0 0 253 0 0 0 0 0 0 0 0 253 64 0 0 0 253 64 0 0 0 0 0 0 0 253 253 253 0 0 0 0 0 0 0 0 0 0 0 0 
36 0 0 0 177 254 0 0 0 177 254 0 0 0 177 4 0 0 0 177 254 254 253 0 0 0 0 0 35 0 35 35 35 35 35 35 35 35 0 219 0 0 0 0 0 0 253 0 254 0 0 0 0 0 0 0 0 35 35 0 0 0 0 35 0 0 0 0 0 253 0 0 0 253 0 0 0 0 0 0 0 0 253 64 0 0 0 253 64 0 0 0 0 0 0 0 0 253 0 0 0 0 0 0 0 0 254 0 0 0 0 
0 0 0 0 177 0 0 0 0 177 0 0 0 0 177 0 0 0 0 177 254 254 253 0 0 0 0 64 176 176 176 176 176 176 176 176 176 176 176 35 0 64 0 0 64 0 178 0 0 0 0 0 0 0 0 253 253 0 35 35 35 35 35 35 0 0 0 0 35 35 35 35 0 253 0 0 0 0 0 0 0 0 253 64 0 0 0 253 64 0 0 0 0 0 0 0 0 0 0 0 254 0 0 0 0 0 0 0 0 0 0 
0 0 0 0 177 0 0 0 0 177 0 0 0 0 177 0 0 0 64 177 254 254 253 0 0 0 0 0 176 35 35 35 35 35 35 35 176 35 35 35 0 0 0 0 0 0 178 0 0 0 0 35 35 35 0 253 0 0 0 0 0 0 0 0 0 0 0 35 0 0 0 35 0 253 0 0 0 0 0 0 0 0 253 64 0 0 0 253 64 0 0 0 0 0 0 0 0 0 0 0 0 0 0 0 0 0 253 0 0 0 0 
177 177 177 35 177 177 177 177 35 177 177 177 177 35 177 177 177 177 35 177 177 177 177 64 0 0 0 0 176 35 0 0 0 0 0 35 176 35 0 0 0 0 0 0 0 0 178 0 0 0 35 0 0 35 35 0 0 0 0 254 0 0 0 0 0 0 35 0 0 0 0 0 35 0 0 0 0 0 0 0 0 0 253 64 0 0 0 253 64 0 0 0 0 0 0 0 0 0 0 0 0 0 0 0 0 253 253 253 0 0 0 
254 0 0 0 0 0 0 0 0 0 0 0 0 0 0 0 0 0 0 0 64 219 35 0 0 0 0 0 176 35 0 254 0 254 0 35 176 35 0 0 0 0 0 0 0 0 178 0 0 0 35 0 0 0 35 0 0 0 35 35 253 253 253 253 253 253 35 0 0 0 0 0 35 0 0 0 0 0 0 0 0 0 253 64 0 0 0 253 64 0 0 0 0 0 254 0 0 0 0 0 0 0 0 0 0 0 253 0 0 0 0 
254 0 0 0 0 0 0 0 0 0 0 0 0 0 0 0 0 0 0 0 64 219 35 0 0 0 0 0 176 35 0 254 0 254 0 35 176 35 0 0 0 0 0 0 0 0 178 253 253 253 35 35 35 35 35 0 0 0 35 35 0 0 0 0 0 0 35 35 0 0 0 35 35 253 253 253 253 0 0 0 0 0 253 64 0 0 0 253 64 0 0 0 253 0 0 0 0 0 0 0 0 0 0 0 0 0 0 0 0 0 0 
254 0 0 0 0 0 0 0 0 0 0 0 0 0 0 0 0 0 0 0 64 219 35 0 0 0 0 0 176 35 0 0 0 0 0 35 176 35 0 0 0 0 0 0 0 0 178 0 0 0 0 0 35 35 253 253 253 35 35 35 35 0 0 0 0 0 0 35 35 35 35 35 0 0 0 0 253 0 0 0 0 0 253 64 0 0 0 253 64 0 0 253 253 253 0 0 0 0 0 0 0 254 0 0 0 0 254 0 0 0 0 
177 177 177 35 177 177 177 177 35 177 177 177 177 35 177 177 177 177 35 177 177 177 177 64 0 0 0 0 176 35 0 0 4 0 0 35 176 35 0 0 0 0 0 0 0 0 178 0 0 0 0 0 253 0 0 0 0 35 0 0 0 35 0 0 254 0 0 253 0 0 0 0 0 0 0 0 35 35 0 0 0 0 253 64 0 0 0 253 64 0 0 0 253 0 0 0 0 0 0 0 0 0 0 0 0 0 0 0 0 0 0 
0 0 0 0 177 0 0 0 0 177 0 0 0 0 177 0 0 0 0 177 254 254 177 0 0 0 0 0 176 35 0 0 0 0 0 35 176 35 0 0 0 0 0 0 0 0 178 0 0 0 0 0 253 0 0 0 0 35 0 0 0 35 35 0 0 0 0 253 0 0 0 0 0 0 35 35 0 35 35 0 0 0 253 64 0 0 0 253 64 0 0 0 0 0 0 0 0 0 0 0 0 0 0 0 0 0 0 0 0 0 0 
0 0 0 0 177 0 0 0 0 177 0 0 0 0 177 0 0 0 0 177 254 254 177 0 0 0 0 0 176 35 0 254 0 0 0 35 176 35 0 0 0 0 0 0 0 0 178 0 0 0 0 0 253 0 0 0 35 35 0 0 0 0 35 0 0 0 0 253 0 0 0 0 0 35 35 0 0 0 35 0 0 0 253 64 0 0 0 253 64 0 0 0 0 0 0 0 0 0 0 253 0 0 0 0 0 0 0 0 0 0 0 
254 0 0 0 177 254 0 0 0 177 254 0 0 0 177 4 0 0 0 177 254 254 177 0 0 0 0 0 176 35 0 254 0 0 0 35 176 35 0 0 0 0 0 0 0 0 178 0 0 0 0 0 253 0 0 0 0 35 0 0 0 35 35 0 0 0 0 253 0 0 0 253 253 35 35 0 0 0 35 0 0 0 253 64 0 0 0 253 64 0 0 0 0 0 0 0 254 0 253 253 253 0 0 0 0 0 0 0 0 0 0 
177 177 177 177 177 177 177 177 177 177 177 177 177 177 177 177 177 177 177 177 177 177 177 0 0 0 0 0 176 35 0 0 0 0 0 35 176 35 0 0 0 0 0 0 0 0 178 0 0 0 0 0 253 0 0 0 0 0 35 0 35 35 0 0 0 35 35 35 35 0 253 253 0 0 35 0 0 0 35 0 0 0 253 64 0 0 0 253 64 0 0 0 0 0 0 0 0 0 0 253 0 0 0 0 0 0 0 0 0 0 0 
64 0 0 0 0 0 0 0 0 0 0 0 0 0 0 0 0 0 0 0 0 0 0 0 0 0 0 0 176 35 0 0 0 254 0 35 176 35 0 0 64 0 64 0 64 0 178 0 0 0 0 0 253 0 0 0 0 0 35 35 35 0 253 253 35 0 0 0 0 35 35 0 0 0 35 35 35 35 35 0 0 0 253 64 0 0 0 253 64 0 0 0 0 254 0 0 0 0 0 0 0 0 0 0 0 0 254 0 0 0 0 
0 0 0 0 0 0 0 0 0 0 0 0 0 0 0 0 0 0 0 0 0 0 0 0 0 0 0 0 176 35 0 0 0 0 0 35 176 35 0 0 0 0 0 0 0 0 178 0 0 0 0 35 35 35 0 0 0 253 253 0 0 0 0 0 35 35 0 0 0 0 35 35 0 0 0 0 0 0 0 0 0 0 253 64 0 0 0 253 64 0 0 0 0 0 0 0 0 0 0 0 0 0 0 254 0 0 0 0 0 0 0 
64 0 0 0 0 0 0 64 0 0 0 0 64 0 0 0 0 0 0 0 0 0 0 0 0 0 0 0 176 35 0 0 0 0 0 35 176 35 0 0 64 0 64 0 64 0 178 253 253 253 253 35 0 35 35 35 0 253 0 0 0 0 0 0 35 0 0 0 0 0 0 35 0 0 0 0 0 0 0 0 0 0 253 64 0 0 0 253 64 0 0 0 35 0 0 0 0 0 0 0 0 0 0 0 0 0 0 0 0 0 0 
176 176 176 176 176 176 176 176 35 0 0 35 176 176 176 176 176 176 176 176 176 176 176 176 176 176 176 176 176 35 0 0 0 0 0 35 176 35 0 0 0 0 0 0 0 0 178 0 0 0 0 35 0 0 0 35 35 253 0 0 0 0 0 0 35 0 0 0 0 0 0 35 0 0 0 0 0 0 0 0 0 0 253 64 0 0 0 253 64 0 0 35 35 35 0 0 0 0 254 0 0 0 0 0 0 0 0 0 0 0 0 
176 254 0 0 0 177 0 0 0 0 0 0 35 0 0 0 0 0 0 0 0 0 0 0 0 0 0 0 176 35 0 0 254 0 0 35 176 35 0 35 35 35 35 35 35 35 178 0 0 0 0 35 35 0 0 0 35 0 0 0 0 0 0 0 35 35 0 0 0 0 35 35 0 0 0 0 0 0 0 0 0 0 253 64 0 0 0 253 64 0 0 0 35 0 0 0 0 0 0 0 0 0 0 253 0 254 0 0 0 0 0 
176 0 91 64 93 177 0 0 0 0 0 0 0 0 0 91 254 93 91 254 93 91 254 93 91 254 93 0 176 35 0 0 254 0 0 35 176 35 0 35 178 178 178 178 178 178 178 0 0 0 0 0 35 35 0 0 35 0 0 0 0 0 0 0 0 35 35 0 0 0 35 0 0 0 0 0 254 0 0 0 0 0 253 64 0 0 0 253 64 0 0 0 0 0 0 0 0 0 0 0 0 0 253 253 253 0 0 0 0 0 0 
176 0 91 64 93 177 0 0 0 0 0 0 0 0 0 91 254 93 91 0 93 91 64 93 91 254 93 0 176 35 0 0 0 0 0 35 176 35 0 35 178 178 178 178 178 178 178 0 0 0 0 0 0 35 0 0 35 0 0 0 0 0 0 0 0 0 35 35 35 35 35 0 0 0 0 0 0 0 0 0 0 0 253 64 0 0 0 253 64 0 0 0 0 0 0 0 0 0 0 0 0 0 0 253 0 0 0 0 0 0 0 
176 0 91 64 93 177 0 0 0 0 0 0 0 0 0 91 0 93 91 64 93 91 254 93 91 0 93 0 176 35 0 254 0 0 0 0 176 35 0 35 178 178 0 0 0 0 178 0 0 0 0 0 0 35 35 35 35 0 0 0 0 0 0 0 0 0 0 0 0 0 253 0 0 0 0 0 0 0 0 0 0 0 253 64 0 0 0 253 64 0 0 0 0 254 0 0 254 0 0 0 0 0 0 0 0 254 0 0 0 0 254 
176 0 0 0 0 177 64 0 0 0 0 0 0 0 0 91 4 93 91 254 93 91 254 93 91 254 93 0 176 35 0 254 0 0 0 35 176 35 0 35 178 178 0 36 36 36 178 0 0 0 0 0 0 0 253 0 0 0 0 0 0 0 0 254 0 0 0 0 0 0 253 0 0 0 0 254 0 0 0 0 0 0 253 64 0 0 0 253 64 0 91 82 101 99 111 114 100 93 0 50 53 0 72 80 0 0 0 0 0 0 177 
176 64 0 0 0 219 0 0 0 0 0 0 35 0 0 0 0 0 0 0 0 0 0 0 0 0 0 0 176 35 0 0 0 254 0 35 176 35 0 35 178 178 0 36 36 36 178 0 0 0 0 0 0 0 253 253 0 0 0 0 0 0 0 0 0 0 0 0 0 0 253 0 0 0 0 0 0 0 0 0 0 0 253 64 0 0 0 253 64 0 91 82 101 99 111 114 100 93 0 97 108 108 0 99 111 105 110 115 0 177 177 
176 176 176 176 176 176 176 176 176 176 176 176 176 176 176 176 176 176 176 176 176 176 176 176 176 176 176 176 176 35 0 0 254 254 0 35 176 35 0 35 178 178 0 36 36 36 178 0 0 0 0 0 0 0 0 253 0 0 0 0 0 0 0 0 0 0 0 0 0 0 253 0 0 0 0 0 0 0 0 0 0 0 253 64 0 0 0 253 64 0 91 82 101 99 111 114 100 93 0 48 0 98 111 109 98 115 0 0 177 177 21 
3