0 253 253 253 253 253 253 253 253 253 253 253 253 253 253 253 253 253 253 253 0 0 0 0 0 0 0 0 0 0 0 0 0 0 0 0 0 0 0 0 0 0 0 0 0 0 0 0 0 0 0 0 178 0 0 0 0 0 0 0 0 0 0 176 0 0 0 0 0 0 0 0 0 0 0 0 0 0 0 0 0 0 0 0 0 0 0 0 0 0 0 0 0 0 0 0 0 0 0 0 0 0 0 0 0 0 0 0 0 0 0 
219 178 178 178 178 178 178 178 178 178 178 178 178 178 178 178 178 178 178 178 178 178 178 178 178 178 178 178 178 178 178 178 178 178 178 178 178 178 178 178 178 178 178 178 178 178 178 178 178 178 178 0 178 0 178 178 178 178 178 0 0 0 0 176 0 91 82 101 99 111 114 100 93 0 52 48 0 72 80 0 0 0 0 0 0 0 0 0 0 0 0 0 0 0 0 0 0 0 0 0 0 0 0 0 0 0 0 0 0 0 0 
0 70 111 114 0 101 36 99 97 112 101 0 121 111 117 0 97 114 101 0 100 101 36 116 105 110 101 100 0 116 111 0 116 104 101 0 100 101 97 116 104 0 112 101 110 97 108 116 121 0 178 0 178 0 178 64 64 64 178 0 0 35 0 176 0 91 82 101 99 111 114 100 93 0 97 108 108 0 99 111 105 110 115 0 0 0 64 0 0 0 0 0 0 0 0 0 0 0 0 0 0 0 0 0 0 0 0 0 0 0 0 
178 178 178 178 178 178 178 178 178 178 178 178 178 178 178 178 178 178 178 178 178 178 178 178 178 178 178 178 178 178 178 178 178 178 178 178 178 178 178 178 178 178 178 178 178 178 178 178 178 178 178 0 178 0 178 64 21 64 178 0 0 0 0 176 0 91 82 101 99 111 114 100 93 0 48 0 98 111 109 98 115 0 0 0 0 0 0 0 0 0 0 0 0 64 0 0 0 0 0 0 0 0 0 0 0 0 0 0 0 0 0 
64 64 64 64 64 64 64 64 64 64 64 64 64 64 64 64 64 64 64 64 64 64 64 64 64 64 64 64 64 64 64 64 64 64 64 64 64 64 64 64 0 0 0 0 0 0 0 0 0 0 178 0 178 0 178 64 64 64 178 0 35 0 0 176 0 0 0 0 0 0 0 0 0 0 0 0 0 0 0 0 0 0 0 0 0 0 0 0 0 0 0 0 0 0 0 0 0 0 0 0 0 0 0 0 0 0 0 0 0 0 0 
64 64 43 43 43 43 43 43 43 43 43 64 64 64 43 43 43 43 43 43 43 43 43 43 43 64 64 64 64 64 64 43 43 43 43 43 43 43 64 64 0 0 0 0 0 0 0 0 0 0 178 0 178 0 178 178 178 178 178 0 0 0 0 176 0 0 0 0 0 0 0 0 0 0 0 0 0 0 0 0 0 0 0 0 0 0 0 43 0 0 0 0 0 0 0 0 0 0 0 0 0 0 0 0 0 0 0 0 0 0 0 
64 64 43 64 64 64 64 64 64 64 43 43 64 64 64 64 64 43 64 64 64 64 64 64 43 43 64 64 64 64 64 43 64 64 64 64 64 43 64 64 0 0 0 0 0 0 0 0 0 0 178 0 178 0 0 0 0 0 0 0 0 0 0 176 0 0 0 0 0 0 0 0 0 0 0 0 0 0 0 0 0 0 0 0 0 0 43 43 0 0 0 0 0 0 0 0 0 0 0 0 0 64 0 0 0 0 0 0 0 0 0 
64 43 43 64 64 64 64 64 43 64 64 43 43 64 64 64 64 64 64 64 64 64 64 64 64 43 64 64 64 64 64 43 64 64 64 64 64 64 64 64 0 0 0 0 0 0 0 0 0 0 178 0 178 0 0 35 0 0 0 0 35 0 0 176 0 0 0 0 0 0 0 0 0 0 0 0 0 0 0 0 0 0 0 0 0 43 43 43 0 0 0 0 0 0 0 0 0 0 0 0 0 0 0 0 0 0 0 0 0 0 0 
64 43 64 64 64 64 64 64 43 64 64 64 43 43 43 43 43 43 43 43 43 43 43 43 43 43 43 43 43 43 43 43 43 43 43 43 43 43 43 43 0 0 0 0 0 0 0 0 0 0 178 0 178 0 0 0 0 0 0 0 0 0 0 43 0 0 0 0 0 0 0 0 0 43 43 43 0 0 0 0 0 0 0 0 43 43 0 43 43 0 0 0 0 0 0 0 0 0 0 0 0 0 0 0 0 0 0 0 0 0 0 
64 43 64 64 64 64 64 64 43 64 64 64 43 64 64 64 64 64 43 64 64 64 64 64 43 43 64 43 43 64 64 64 64 43 64 43 64 64 64 64 0 0 0 0 0 0 0 0 0 0 178 0 178 0 0 0 0 0 0 0 0 0 0 176 0 0 0 0 0 0 0 0 0 43 43 43 43 43 43 43 0 0 0 43 43 0 0 0 43 0 0 0 0 0 0 0 0 0 0 0 0 0 0 0 0 0 0 0 0 0 0 
64 43 64 64 64 43 43 43 43 64 64 64 64 43 43 43 64 64 43 43 64 64 64 43 64 64 43 64 64 43 64 64 64 64 43 64 43 43 64 64 0 0 0 0 0 0 0 0 0 0 178 0 178 0 0 0 0 0 0 0 0 0 0 176 0 0 0 0 0 0 0 0 0 0 0 43 43 43 0 43 43 43 43 43 0 0 0 0 43 0 0 0 0 0 0 0 0 0 0 0 0 0 0 0 0 0 0 0 0 0 0 
43 43 64 64 43 43 43 43 64 64 64 64 64 43 64 43 43 64 64 43 64 64 64 43 43 43 43 43 43 64 64 64 64 64 43 64 64 43 64 64 0 0 0 0 0 0 0 0 0 0 178 0 178 0 0 0 35 0 0 0 0 0 0 176 0 0 0 0 0 0 0 0 0 0 0 0 0 43 43 0 0 0 43 43 43 43 43 43 43 43 0 0 0 0 0 0 0 0 0 0 0 0 0 0 0 0 0 0 0 0 0 
43 64 64 64 43 64 64 43 64 64 64 64 64 43 64 64 43 43 64 43 43 64 43 43 64 64 64 43 64 64 64 64 64 64 43 64 64 43 64 64 0 0 0 0 0 0 0 0 0 178 219 219 219 178 0 0 0 0 0 0 0 0 0 176 0 0 0 0 64 0 0 0 0 0 0 0 0 0 43 43 43 43 43 0 0 0 0 0 43 43 43 43 43 43 43 0 0 0 0 0 0 0 0 0 0 0 0 0 0 0 0 
43 64 64 64 43 64 64 43 43 43 64 64 64 43 64 64 64 43 64 64 43 43 43 64 64 43 43 43 43 43 43 43 43 64 43 64 64 43 64 64 0 0 0 0 0 0 0 0 178 0 0 0 0 0 178 0 0 0 0 0 0 0 0 176 0 0 0 0 0 0 0 0 0 0 0 0 0 0 0 0 43 43 0 0 0 0 36 0 0 43 43 0 0 0 43 43 43 43 43 43 43 43 43 0 0 0 64 0 0 0 0 
43 64 64 43 43 64 64 64 64 43 43 64 64 43 64 64 64 43 43 64 64 64 64 64 64 64 64 64 64 64 64 64 43 43 43 64 64 43 64 64 0 0 0 0 0 0 0 219 219 219 219 219 219 219 219 219 0 0 0 0 0 0 0 176 0 0 0 0 0 0 0 0 0 0 0 0 0 0 43 43 43 43 43 43 0 0 0 0 0 0 43 0 0 0 0 0 43 43 43 43 43 0 0 0 0 0 0 0 0 0 0 
43 64 43 43 64 64 64 64 64 64 64 43 43 43 43 43 43 64 43 43 43 43 43 43 64 64 64 64 64 64 64 64 64 64 43 64 64 43 64 64 0 0 0 0 0 0 178 0 0 0 0 0 0 0 0 0 178 0 0 0 0 0 0 176 0 0 0 0 0 0 0 0 0 0 0 0 0 0 43 0 0 0 0 43 43 43 0 0 0 0 43 43 43 43 43 43 43 0 0 0 0 0 0 0 0 0 0 0 0 0 0 
43 64 64 43 64 64 64 64 64 64 64 64 64 64 64 64 43 43 64 64 64 64 64 43 43 43 43 43 43 43 64 64 64 64 43 43 43 43 64 64 0 0 0 0 0 0 178 219 219 219 219 219 219 219 219 219 178 0 0 0 0 0 0 176 0 0 0 0 0 0 0 0 0 0 0 0 0 43 0 0 0 0 0 0 0 43 43 43 43 43 43 43 43 0 0 0 0 0 0 0 0 0 0 0 0 0 0 0 0 0 0 
43 64 64 43 64 43 43 43 43 43 43 64 64 64 64 64 64 43 43 43 43 64 64 64 64 64 64 43 43 64 64 64 64 43 43 64 43 43 43 64 0 0 0 0 0 0 178 0 0 0 0 0 0 0 0 0 178 0 0 0 0 35 0 176 0 0 0 0 0 0 0 0 0 0 0 43 43 43 0 0 43 43 43 43 43 43 0 43 43 43 0 0 43 0 0 0 0 0 0 0 0 0 0 0 0 0 0 0 0 0 0 
43 64 64 43 64 43 64 43 64 64 43 43 43 64 64 43 43 43 64 64 43 43 43 43 64 64 64 64 43 43 43 43 43 43 64 64 64 43 64 64 0 0 0 0 0 0 178 219 219 219 219 219 219 219 219 219 178 0 0 0 0 0 0 176 0 0 0 0 0 0 64 0 0 0 43 43 43 43 43 43 0 0 0 0 0 0 0 0 0 43 43 43 0 43 0 0 0 0 0 0 0 0 0 64 0 0 0 0 0 0 0 
43 64 64 43 64 43 64 43 64 64 64 64 43 64 43 64 64 64 64 64 64 64 43 43 43 43 43 64 43 64 64 64 64 43 64 64 64 43 64 64 0 0 0 0 0 0 178 0 0 0 0 0 0 0 0 0 178 0 0 0 0 0 0 176 0 0 0 0 0 0 0 0 0 0 0 0 0 0 0 0 0 0 0 0 0 0 0 0 0 0 0 43 43 43 0 0 0 0 0 0 0 0 0 0 0 0 0 0 0 0 0 
43 43 64 64 43 43 64 43 43 43 64 43 43 43 43 64 64 43 43 64 64 43 43 64 64 43 64 43 43 64 64 64 64 64 64 64 64 43 64 64 0 0 0 0 0 0 178 178 178 178 178 43 178 178 178 178 178 0 0 0 0 0 0 176 0 0 0 0 0 0 0 0 0 0 0 0 0 0 0 0 0 0 0 0 0 0 0 0 0 0 0 0 0 43 43 0 0 0 0 0 0 0 0 0 0 0 0 0 0 0 0 
64 43 43 43 43 64 64 64 64 64 43 64 64 64 64 64 43 43 64 64 43 64 64 64 64 43 64 43 43 64 64 64 64 43 43 64 64 43 64 64 0 0 0 0 0 0 178 0 0 0 0 0 0 0 0 0 178 0 0 0 0 0 0 176 0 0 0 0 0 0 0 0 0 0 0 0 0 0 0 0 0 0 0 0 0 0 0 0 0 0 0 0 0 0 0 0 0 0 0 0 0 0 0 0 0 0 0 0 0 0 0 
64 64 64 64 64 64 64 64 64 64 43 64 64 64 64 64 43 64 64 64 43 64 64 64 64 43 64 43 43 43 43 43 43 43 64 64 64 43 64 64 253 253 253 253 253 253 178 0 0 0 0 0 0 0 0 0 178 0 35 0 0 0 0 176 0 0 0 0 0 0 0 0 0 0 0 0 0 0 64 0 0 0 0 0 0 0 0 0 0 0 0 0 0 0 0 0 0 0 64 0 0 0 0 0 0 0 0 0 0 0 0 
64 64 64 64 43 43 43 43 43 43 43 43 43 43 43 43 43 43 43 43 43 43 43 64 64 43 64 64 64 64 64 64 64 64 64 64 64 64 64 64 0 0 0 0 0 0 178 0 0 0 0 0 0 0 0 0 178 0 0 0 0 0 0 176 0 0 0 0 0 0 0 0 0 0 0 0 0 0 0 0 0 0 0 0 64 0 0 0 0 0 0 64 0 0 0 0 0 0 0 0 0 0 0 0 0 0 0 0 0 0 0 
64 64 64 43 43 64 64 64 64 64 64 64 64 64 64 64 64 64 64 43 64 64 43 64 64 43 43 43 43 43 43 43 43 43 43 43 43 43 64 64 0 0 0 0 0 0 178 0 0 0 0 0 0 0 0 0 178 0 0 0 0 0 0 176 0 0 0 0 0 0 0 0 0 0 0 0 0 0 0 0 0 0 0 0 0 0 0 0 0 0 0 0 0 0 0 0 0 0 0 0 0 0 0 0 0 0 0 0 0 0 0 
64 64 43 43 64 43 43 43 43 43 43 43 43 43 43 43 43 43 43 43 64 64 43 64 64 64 64 64 64 64 64 64 64 64 64 64 64 43 64 64 0 0 4 4 0 0 178 0 0 0 0 0 0 0 0 0 178 0 0 0 0 35 0 176 0 0 0 0 0 0 0 0 0 0 0 0 0 0 0 0 0 0 0 0 0 0 0 0 0 0 0 0 0 0 0 0 0 0 0 0 0 0 0 0 0 0 0 0 0 0 0 
43 43 43 64 43 43 64 64 64 64 64 64 64 64 64 64 43 64 64 64 64 64 43 43 43 43 43 43 43 43 43 43 43 43 43 43 43 43 64 64 0 0 0 0 0 0 178 0 0 0 0 0 0 0 0 0 178 0 0 0 0 0 0 176 0 64 0 0 0 0 0 0 0 0 0 0 0 0 0 0 0 0 0 0 0 0 0 0 0 0 0 0 0 0 0 0 0 0 0 0 0 0 0 0 0 0 0 0 0 0 0 
43 64 64 64 64 64 64 64 64 64 64 64 64 64 64 64 64 64 64 64 64 64 64 64 64 64 64 64 64 64 64 64 64 64 64 64 64 64 64 64 176 176 176 176 176 176 178 0 0 0 0 0 0 0 0 0 178 176 176 176 176 176 176 176 253 176 253 176 176 176 176 176 176 176 176 176 176 176 176 176 176 176 176 176 176 176 176 176 176 176 176 176 176 176 176 176 176 176 176 176 176 176 176 176 176 176 176 176 176 176 219 
0 0 0 0 0 0 0 43 0 0 0 0 0 0 0 0 0 0 0 0 0 0 0 0 0 0 0 0 0 0 0 0 0 0 0 0 0 0 0 0 0 0 0 0 0 0 178 0 0 0 0 0 0 0 0 0 178 0 0 0 0 0 0 0 0 176 0 0 0 0 0 0 0 0 0 0 0 0 0 0 0 0 0 0 0 0 0 0 0 0 0 0 0 0 0 0 0 0 0 0 0 0 0 0 0 0 0 0 0 0 0 
0 0 0 0 0 0 0 253 253 253 253 253 253 253 253 253 253 253 253 253 253 253 253 253 253 253 253 253 253 253 253 253 253 253 253 253 253 253 253 253 253 253 253 253 253 253 178 0 0 0 0 0 0 0 0 0 178 0 0 35 0 0 0 0 0 176 0 0 0 0 0 0 0 0 0 0 219 219 0 0 0 0 0 0 0 0 219 219 0 0 0 0 0 0 0 0 0 0 0 0 0 0 0 0 219 219 0 0 0 0 0 
0 0 0 0 0 0 0 64 0 0 0 64 0 0 0 64 0 0 0 0 0 0 0 0 0 0 0 0 0 0 0 0 0 0 0 0 0 0 0 0 0 0 0 0 0 0 178 0 0 0 0 0 0 0 0 0 178 0 0 0 0 0 0 0 0 176 0 0 0 0 0 0 0 0 0 219 219 0 219 219 0 0 0 0 0 219 0 219 219 0 0 0 0 0 0 219 219 219 0 0 0 0 0 219 219 219 219 0 0 0 0 
0 0 0 0 0 0 0 64 0 64 0 64 0 64 0 64 0 0 0 0 0 0 0 35 0 0 0 0 0 0 0 0 0 35 0 0 0 0 0 0 0 0 0 0 0 0 178 0 0 0 0 0 0 0 0 0 178 0 0 0 0 0 0 35 0 176 0 0 0 0 219 219 0 0 0 219 0 35 0 219 219 0 0 0 219 0 35 0 0 219 219 0 0 0 219 0 0 0 219 219 0 0 0 219 0 35 219 219 0 0 0 
0 0 0 0 0 0 0 64 0 64 0 64 0 64 0 64 0 35 0 0 0 0 0 0 0 0 0 35 0 0 0 0 0 0 0 0 0 0 0 0 0 0 0 35 0 0 178 0 0 0 0 0 0 0 0 0 178 0 0 0 0 0 0 0 0 176 0 0 0 0 219 219 219 0 0 219 0 0 0 0 219 219 0 219 0 0 0 0 0 0 219 219 0 219 0 35 0 0 0 219 219 0 219 0 0 0 0 219 219 0 219 
253 253 253 253 0 0 0 64 0 64 0 4 0 64 0 64 0 0 0 0 0 0 0 0 0 0 35 4 35 0 0 0 0 0 0 0 0 0 0 0 0 0 0 0 0 0 0 178 0 0 0 253 0 0 0 178 0 0 0 0 0 0 0 0 0 176 0 0 0 0 219 35 0 219 219 219 0 0 0 0 0 0 219 219 0 0 0 0 0 0 0 0 219 0 0 0 0 0 0 0 219 219 219 0 0 0 0 0 219 219 219 
35 35 35 253 0 0 0 64 0 64 0 64 0 64 0 64 0 0 0 0 0 0 0 0 0 0 0 35 0 0 0 0 0 0 0 0 0 0 35 0 0 0 0 0 0 0 0 0 178 0 0 0 0 0 178 0 0 0 0 35 0 0 0 0 0 176 0 0 0 0 219 0 0 0 219 219 0 0 0 0 0 0 35 0 0 0 0 0 0 0 0 0 0 35 0 0 0 0 0 0 0 0 35 0 0 0 0 0 219 219 35 
64 64 35 253 0 0 0 43 0 64 0 64 0 64 0 64 0 0 0 0 0 35 0 0 0 0 0 0 0 0 0 0 35 0 0 0 0 0 0 0 0 0 0 0 0 0 0 0 0 178 178 178 178 178 0 0 0 0 0 0 0 0 0 0 0 176 0 0 0 219 219 0 0 0 0 0 35 0 0 0 0 0 0 0 0 0 0 0 0 0 0 0 0 0 0 0 0 0 0 0 0 0 0 0 0 0 0 0 0 35 0 
254 64 35 253 0 0 0 43 0 64 0 64 0 64 0 64 0 0 0 0 0 0 0 0 0 0 0 0 0 0 0 0 0 0 0 0 0 0 0 0 0 0 0 0 0 0 0 0 0 43 43 120 43 43 0 0 0 0 0 0 0 0 0 0 0 176 0 0 219 219 36 35 0 0 0 0 0 0 0 0 0 0 0 0 0 70 111 114 0 116 104 101 0 103 108 111 114 121 0 111 102 0 83 97 116 97 110 0 0 0 0 
3