0 0 0 0 0 0 0 0 0 177 0 0 0 0 0 0 177 0 0 0 0 0 0 0 0 0 177 0 0 0 0 0 0 0 0 0 0 0 0 177 0 0 0 0 177 0 0 0 0 0 0 0 177 0 177 0 177 0 0 0 0 0 0 0 0 0 177 0 0 0 0 0 0 0 0 0 0 177 177 177 177 177 177 177 177 177 177 177 177 0 0 0 0 91 82 101 99 111 114 100 93 0 55 53 0 72 80 0 0 0 254 
0 177 177 177 177 177 177 177 0 177 0 0 0 0 0 0 177 0 0 0 0 0 0 0 0 0 177 0 0 0 0 0 0 0 0 0 0 0 0 177 0 0 0 0 177 0 0 0 0 0 0 0 177 0 177 0 177 0 0 0 177 177 177 177 177 177 177 0 0 0 0 0 0 0 177 177 177 177 0 0 0 0 0 0 0 0 0 0 177 177 177 177 0 91 82 101 99 111 114 100 93 0 97 108 108 0 99 111 105 110 115 
0 177 0 0 0 0 0 0 0 177 0 0 0 0 0 0 253 0 0 0 0 177 0 0 0 0 253 0 0 0 0 0 177 0 0 0 0 0 0 177 0 0 0 0 177 0 0 0 0 0 0 0 177 0 177 0 177 0 0 0 0 0 0 0 0 0 177 254 0 0 0 0 0 0 177 0 0 0 0 0 0 0 0 0 0 0 0 0 0 0 0 0 177 91 82 101 99 111 114 100 93 0 52 0 98 111 109 98 115 0 0 
0 177 0 0 0 0 177 0 0 177 177 177 177 177 177 177 177 177 177 0 0 177 0 0 0 177 177 177 0 0 0 0 177 0 0 0 0 0 254 177 0 0 0 0 253 0 0 0 177 0 0 0 177 0 177 0 177 0 0 0 0 0 0 0 0 0 177 177 177 177 177 177 177 177 177 177 177 177 177 0 0 0 0 0 0 0 0 0 0 0 0 0 0 177 0 0 0 0 0 0 0 177 0 0 0 0 0 0 0 0 0 
0 177 0 177 177 177 177 177 177 177 0 0 0 0 0 177 0 0 0 0 177 177 0 0 0 0 0 177 177 177 0 0 177 177 177 177 177 177 177 177 0 0 177 177 177 177 177 177 177 0 0 0 177 0 177 0 177 0 0 0 0 0 0 0 0 0 0 0 0 0 0 0 0 177 254 253 253 253 253 0 0 0 0 0 177 0 0 0 0 0 0 0 0 0 177 0 0 0 0 0 0 177 0 0 0 0 0 0 0 0 0 
0 177 0 0 177 0 0 0 0 177 0 0 177 0 0 177 0 0 0 177 177 0 0 0 0 0 0 0 0 177 0 0 177 0 0 0 0 177 0 0 0 0 0 0 0 0 0 0 177 0 0 0 177 0 177 0 177 0 0 0 177 177 177 177 0 0 0 0 0 0 0 0 0 177 177 177 177 177 177 0 0 0 0 0 177 0 0 0 0 0 0 0 0 0 0 177 0 0 0 0 0 177 0 0 0 0 0 0 0 0 0 
0 177 0 0 177 0 254 0 0 177 0 0 177 0 0 177 0 0 0 177 0 0 0 177 0 0 0 0 0 177 0 0 177 0 0 0 0 177 0 0 0 0 0 0 0 0 0 0 177 0 0 0 177 0 177 0 177 0 0 0 0 0 0 177 177 177 177 0 0 0 0 0 0 177 0 0 0 0 177 177 177 177 177 177 177 177 177 177 177 177 177 0 0 0 0 0 253 0 0 0 0 177 0 0 0 0 0 0 0 0 0 
0 177 36 0 177 0 0 0 0 177 0 0 177 0 0 177 0 0 0 177 0 0 0 177 0 0 0 0 0 177 177 177 177 177 0 0 0 177 0 0 177 177 177 177 177 177 177 0 177 0 0 0 177 253 177 0 253 0 0 0 0 0 0 0 0 0 177 177 177 177 177 177 177 177 0 0 0 0 0 0 253 0 0 0 0 0 0 0 0 0 177 0 0 0 0 0 0 177 0 0 0 177 177 177 177 177 177 177 177 177 0 
0 177 177 0 177 0 0 0 0 177 0 0 177 0 0 177 0 177 177 177 177 177 177 177 0 0 0 0 0 177 0 0 0 177 177 0 177 0 0 0 177 0 0 0 0 0 0 0 177 0 0 0 177 254 177 0 177 177 177 177 177 177 177 0 0 0 0 0 177 0 0 0 0 177 0 0 0 0 0 0 177 0 0 0 0 0 0 0 0 0 177 0 0 0 0 0 0 177 177 177 177 177 0 0 0 0 0 0 0 0 0 
0 0 0 0 177 0 0 0 0 177 0 0 177 0 0 177 0 0 0 0 253 0 0 177 0 0 0 0 0 177 0 0 0 0 0 0 177 0 0 0 177 253 177 177 177 177 177 177 177 0 0 0 177 253 177 0 0 0 0 0 0 0 0 0 0 0 0 0 177 0 0 0 0 0 0 0 0 0 0 0 177 0 0 0 0 0 0 0 0 0 177 0 0 0 0 0 0 177 0 0 0 177 0 0 0 0 0 0 0 0 0 
177 177 177 177 177 177 0 0 0 177 0 0 177 0 0 177 0 0 0 0 177 0 254 177 0 0 0 254 0 177 0 0 0 0 254 0 177 0 0 0 177 0 0 0 0 0 0 0 177 0 0 0 177 0 177 0 0 0 0 0 0 0 0 0 0 0 0 0 177 0 0 0 0 0 0 0 0 0 0 0 177 177 177 177 177 177 177 177 177 253 177 0 0 0 0 0 0 177 0 36 0 177 177 0 0 0 0 0 0 0 0 
0 0 177 0 0 177 0 0 0 177 0 0 177 0 0 177 0 0 177 177 177 177 177 177 177 177 177 177 177 177 177 177 177 177 0 0 177 0 0 0 177 0 0 0 0 0 254 0 177 0 0 0 177 0 177 0 0 0 0 0 0 0 0 0 0 0 0 0 253 0 0 0 0 0 0 177 0 0 0 0 177 0 0 0 0 0 0 0 0 0 177 0 0 0 0 0 0 177 0 0 0 0 0 177 177 177 177 177 177 177 177 
0 0 0 0 0 177 0 0 0 0 0 0 177 254 0 177 0 0 0 0 0 0 0 0 0 0 0 177 0 0 0 0 0 177 0 0 177 0 0 0 0 177 177 0 177 20 20 20 20 20 20 20 20 177 20 20 20 20 20 20 20 20 177 177 177 177 177 177 177 177 177 177 0 0 0 177 0 0 0 0 177 0 0 0 0 0 0 0 0 0 177 0 0 0 0 0 0 0 177 0 0 0 0 0 0 0 0 0 0 0 0 
0 0 177 0 0 177 177 177 177 177 177 177 177 177 177 177 177 177 177 177 177 177 177 177 177 0 0 177 0 0 0 0 0 177 0 0 177 0 0 0 0 177 0 0 177 20 0 0 0 0 0 0 0 0 0 0 0 0 0 0 0 20 0 0 0 0 177 0 0 177 0 0 0 0 0 177 0 0 0 0 0 177 0 0 0 0 0 0 0 0 177 177 177 177 177 177 177 177 177 177 177 177 177 177 177 177 177 0 0 0 0 
177 0 177 0 177 177 0 0 0 0 177 0 0 0 0 0 0 0 177 0 0 0 0 0 0 0 177 0 0 0 0 0 0 177 0 0 177 0 0 0 0 177 0 0 0 20 0 0 0 0 0 0 0 0 0 0 0 0 0 0 0 20 0 0 0 0 0 0 0 177 0 0 0 0 177 177 177 253 253 253 253 177 0 0 0 0 0 0 0 0 177 0 0 0 0 0 0 0 0 0 0 0 0 0 0 177 0 0 0 0 0 
0 0 177 0 0 177 0 0 0 0 177 0 0 177 0 0 0 0 177 0 0 0 0 0 0 0 177 0 0 0 177 0 0 177 0 0 177 0 0 0 0 177 177 0 0 20 0 0 0 0 0 0 0 0 0 0 0 0 0 0 0 20 0 0 0 0 177 0 0 177 0 0 0 177 0 0 0 0 0 0 0 177 0 0 0 0 0 0 0 0 177 0 0 0 0 0 0 0 0 0 0 0 254 0 0 177 177 177 177 0 0 
0 0 177 0 0 177 0 0 0 0 177 0 0 177 0 0 0 0 177 0 0 0 0 0 177 253 0 0 0 0 177 0 254 177 0 0 0 0 0 0 0 177 0 0 0 20 0 0 0 0 0 4 0 36 0 4 0 0 0 0 0 20 177 177 0 0 177 0 0 177 0 0 0 253 0 0 0 254 254 0 0 177 0 0 0 0 0 0 0 0 177 0 0 0 0 0 0 0 0 0 0 0 254 0 0 177 177 177 177 177 0 
0 0 177 0 254 177 0 0 0 0 177 0 0 177 0 0 0 0 0 0 0 0 0 0 177 0 0 0 0 0 177 177 177 177 0 0 0 0 0 0 0 177 0 0 0 20 0 0 0 0 0 0 0 0 0 0 0 0 0 0 0 20 0 0 0 0 177 0 0 177 177 177 177 177 177 177 177 177 177 177 177 177 177 177 177 177 0 0 0 0 35 0 0 0 0 0 0 0 0 0 0 0 0 0 0 177 0 0 0 0 0 
0 177 177 177 177 177 177 177 0 177 177 177 177 177 177 177 177 177 177 177 177 177 0 0 177 0 0 0 0 0 177 254 0 177 0 0 0 0 0 0 0 177 0 0 0 20 0 0 0 0 0 36 0 21 0 36 0 0 0 0 0 20 0 0 0 177 177 0 0 177 0 0 0 0 0 0 0 177 0 0 0 0 0 177 0 0 0 0 0 0 177 177 177 177 177 177 177 177 177 177 177 177 177 177 177 177 0 177 0 0 0 
0 0 177 0 0 0 0 0 0 177 36 36 36 36 36 177 0 0 0 0 0 0 0 177 177 177 177 177 0 0 177 0 0 177 177 177 177 177 177 177 177 177 0 0 0 20 0 0 0 0 0 0 0 0 0 0 0 0 0 0 0 20 0 0 0 177 0 0 0 177 0 0 0 0 0 0 0 177 0 0 254 0 0 177 0 0 0 0 0 0 0 0 0 0 0 0 0 0 177 0 0 0 0 0 0 177 0 177 0 0 0 
0 0 177 177 177 177 177 0 0 177 36 36 36 36 36 177 0 0 0 0 0 0 0 0 177 0 0 0 0 0 177 0 0 0 0 177 0 0 0 0 253 0 0 0 0 20 0 0 0 0 0 4 0 36 0 4 0 0 0 0 0 20 0 0 0 177 0 0 0 0 0 0 0 0 0 36 0 177 0 0 0 0 0 177 0 0 0 0 0 0 0 0 0 0 0 0 0 0 177 0 0 0 0 0 0 177 0 177 0 0 0 
0 0 177 0 0 0 0 0 0 177 254 254 254 254 254 177 177 177 177 177 177 177 177 0 177 254 0 0 0 0 177 0 0 0 0 0 0 0 0 0 177 177 177 177 177 20 0 0 0 0 0 0 0 0 0 0 0 0 0 0 0 20 254 0 0 177 0 0 0 0 0 0 0 0 0 0 0 177 0 0 177 0 0 177 177 177 177 177 0 0 0 0 0 0 0 0 0 0 177 0 0 0 0 0 0 177 0 177 0 0 254 
0 0 177 0 0 0 0 0 0 177 0 0 0 0 0 177 0 0 0 0 0 0 0 0 177 177 177 177 177 177 177 177 177 177 177 177 177 177 177 0 0 0 0 0 177 20 0 0 0 0 0 0 0 0 0 0 0 0 0 0 0 20 177 177 177 177 177 177 177 177 177 177 177 177 177 177 177 177 0 0 177 0 0 177 0 0 0 0 177 177 177 177 177 177 0 0 0 0 177 0 0 0 0 0 0 177 0 177 177 177 177 
0 0 177 177 177 177 177 177 177 177 0 0 0 0 0 177 0 0 0 0 0 0 0 0 177 0 0 0 0 0 0 0 0 0 0 177 0 0 0 0 0 0 0 0 0 20 0 0 0 0 0 0 0 0 0 0 0 0 0 0 0 20 177 0 0 0 0 0 0 177 0 0 0 0 0 0 0 0 0 177 177 0 0 177 0 0 0 0 0 0 0 0 177 177 0 0 0 0 177 0 0 0 0 0 0 177 0 177 0 0 0 
0 0 177 0 0 0 0 0 0 177 177 177 35 177 177 177 0 0 0 0 0 0 0 0 177 177 177 177 177 177 177 0 0 0 0 177 0 0 0 0 0 0 0 0 0 20 20 20 20 20 20 20 20 20 20 20 20 20 20 20 20 20 177 0 0 0 0 0 0 177 0 0 0 0 177 177 177 177 177 177 177 0 0 177 0 0 0 0 0 0 254 0 177 177 177 177 177 0 177 0 0 0 0 0 0 177 0 177 0 0 0 
0 0 177 0 0 0 0 0 0 0 0 0 0 0 0 0 0 0 0 0 0 0 0 0 177 0 0 0 0 0 0 0 0 0 177 177 0 0 0 0 0 0 0 0 0 0 0 0 0 254 177 0 254 177 254 0 0 177 0 0 0 0 177 254 0 0 0 0 0 177 0 0 0 0 0 0 0 0 0 0 177 0 177 177 0 0 0 0 0 0 0 0 177 0 0 0 0 0 177 0 177 0 0 0 0 0 253 177 0 0 0 
0 0 177 177 177 177 177 177 177 177 177 177 0 0 0 177 177 177 177 177 177 177 177 177 177 0 0 0 0 254 0 0 0 0 177 177 177 177 177 177 177 177 177 177 177 177 177 177 177 177 177 0 177 177 0 0 0 177 177 177 177 177 177 177 177 177 177 177 177 177 177 177 177 177 177 177 177 177 177 253 177 253 177 0 0 0 0 0 0 0 0 0 177 0 0 0 0 0 177 0 177 0 0 0 0 177 0 177 0 0 0 
0 0 177 0 0 0 0 177 0 0 0 0 0 0 0 0 0 0 0 177 0 0 0 0 177 0 0 0 0 0 0 0 0 0 177 0 0 0 0 0 0 0 0 0 0 0 0 0 0 0 0 177 177 0 0 0 0 177 0 0 0 0 0 0 0 0 0 0 0 0 0 0 0 0 0 0 0 0 0 0 177 0 177 0 0 0 0 0 0 0 0 0 177 0 0 0 0 0 177 0 177 0 0 0 0 177 0 0 0 177 0 
0 177 0 0 177 0 254 177 0 0 0 0 0 0 0 0 0 0 0 177 0 254 0 0 177 0 0 177 177 177 177 177 177 177 177 0 0 0 0 0 0 0 177 177 177 177 177 177 177 177 177 0 177 0 0 0 0 177 0 0 0 0 0 0 0 0 0 0 0 0 0 0 0 0 0 0 0 0 0 0 0 0 177 0 0 0 0 177 177 177 177 177 177 0 0 0 0 0 177 0 177 0 0 0 0 177 0 0 0 177 0 
177 0 0 177 177 177 177 177 177 177 177 177 177 177 177 0 0 0 0 177 0 0 0 0 177 0 0 0 0 177 0 0 0 0 177 0 0 0 177 0 0 0 0 0 0 177 0 177 0 0 0 0 177 177 177 177 177 177 177 0 0 0 0 177 177 177 177 177 177 177 0 0 0 0 0 0 0 177 177 177 177 177 177 0 0 0 0 0 0 177 0 0 177 0 0 0 0 0 177 0 177 0 177 177 177 177 0 0 0 177 0 
0 0 0 0 177 0 0 0 0 0 0 0 0 0 0 0 0 0 0 177 0 0 0 0 177 0 0 0 177 177 0 177 177 0 0 0 0 0 0 0 177 0 0 177 0 177 0 177 0 0 0 0 177 0 0 0 0 0 0 0 0 0 0 0 0 0 0 0 0 0 177 177 177 177 177 177 177 0 0 0 0 0 177 177 177 177 177 177 253 177 0 0 177 0 0 0 177 177 177 0 177 0 0 0 0 177 0 0 0 177 0 
0 0 0 0 177 0 0 0 0 0 177 177 177 177 177 177 177 177 177 177 177 177 0 0 177 0 0 0 177 0 0 177 177 0 0 177 0 177 0 0 0 0 0 177 0 177 254 177 0 0 0 0 0 0 0 0 0 0 0 0 0 0 0 0 0 177 177 0 0 0 0 0 0 0 0 0 0 0 0 0 0 0 177 0 0 0 0 0 0 177 0 177 177 177 177 177 177 0 177 0 177 0 0 0 0 177 0 0 0 177 177 
0 0 0 0 177 0 0 0 0 0 0 253 0 0 0 0 0 0 177 0 0 0 0 0 177 0 0 0 177 0 0 0 0 0 0 0 0 0 0 0 0 177 0 0 0 177 0 177 177 177 177 177 177 177 177 177 177 177 177 0 0 0 0 0 177 177 0 0 0 0 0 0 0 0 0 0 0 0 0 0 0 0 177 0 0 0 0 0 0 177 0 0 177 0 0 0 0 0 177 0 177 0 0 0 0 177 0 0 0 177 0 
0 0 0 0 177 0 0 0 0 0 0 253 0 0 0 0 0 0 177 0 0 0 0 0 177 0 0 0 177 177 177 177 177 177 177 177 177 177 177 177 0 0 0 0 0 177 177 177 0 0 0 0 0 0 0 177 177 0 0 0 0 0 0 0 177 0 0 0 0 0 0 0 0 0 0 0 0 0 0 0 0 0 253 0 0 0 0 0 0 177 0 0 177 0 0 0 0 0 0 0 177 0 0 0 0 177 177 0 0 177 0 
0 0 0 0 177 0 0 0 0 0 0 177 0 0 0 0 0 0 177 177 35 177 177 177 177 0 0 0 177 0 0 0 0 0 0 0 177 0 0 0 0 177 0 0 0 0 177 254 0 0 0 0 0 0 0 177 0 253 177 177 177 177 177 177 177 177 177 177 177 177 0 0 0 0 0 0 0 254 177 177 177 177 177 0 0 0 0 0 0 177 0 0 0 0 0 0 0 0 0 0 177 0 0 0 0 0 177 0 0 177 0 
0 0 177 177 177 177 177 177 177 177 177 177 0 0 0 0 0 0 0 0 0 0 0 0 177 0 0 0 177 0 0 0 0 0 254 0 177 0 0 0 0 177 0 0 0 0 177 0 0 0 0 0 0 0 177 177 0 0 0 0 0 0 0 0 0 0 0 0 0 0 177 177 177 177 177 177 177 177 177 0 0 0 0 0 0 0 0 0 0 0 253 0 177 177 177 177 177 177 177 177 177 177 177 177 177 177 177 177 0 177 0 
0 0 0 0 0 0 0 0 0 0 0 0 0 0 0 0 0 0 0 0 0 0 0 0 177 0 0 0 253 0 0 0 0 0 0 0 177 0 0 0 0 177 0 0 0 0 177 0 0 0 0 0 0 0 177 0 0 0 0 0 0 0 0 0 0 0 0 0 0 0 0 0 0 0 0 0 0 0 0 0 0 0 0 0 0 0 0 0 0 0 0 177 0 0 0 0 0 0 0 254 0 0 0 0 0 0 0 177 0 177 254 
1